055 054 054 054 054 034 034 054 054 054 054 053 099 099 099 099 099 099 099 099 099 099 099 099 099 099
055 052 052 052 052 034 034 052 052 052 052 053 099 099 099 099 099 099 099 099 099 099 099 099 099 099
055 034 034 034 034 034 034 034 034 034 034 053 099 099 099 099 099 099 099 099 099 099 099 099 099 099
055 034 034 034 034 034 034 034 034 034 034 053 099 099 099 099 099 099 099 099 099 099 099 099 099 099
055 096 034 034 034 034 034 034 034 034 096 053 099 099 099 099 099 099 099 099 099 099 099 099 099 099
055 034 034 034 034 034 034 034 034 034 034 053 099 099 099 099 099 099 099 099 099 099 099 099 099 099
055 034 034 034 034 034 034 034 034 034 034 053 099 099 099 099 099 099 099 099 099 099 099 099 099 099
055 096 034 034 034 034 034 034 034 034 096 053 055 054 054 054 054 054 054 054 054 054 053 055 054 053
055 034 034 034 034 034 034 034 034 034 034 053 055 052 052 052 052 052 052 052 052 052 053 055 052 053
055 034 034 034 034 034 034 034 034 034 034 053 055 096 096 096 034 034 034 034 034 034 053 055 034 053
055 096 034 034 034 034 034 034 034 034 096 053 055 034 034 034 034 034 034 034 034 034 053 055 034 053
055 034 034 034 034 034 034 034 034 034 034 053 055 034 034 034 034 034 034 034 034 034 054 054 034 053
055 034 034 034 034 034 034 034 034 034 034 054 054 034 034 034 034 034 034 034 034 034 052 052 034 053
055 034 034 034 034 034 034 034 034 034 034 052 052 034 034 034 034 034 096 034 034 034 096 034 034 053
055 034 034 034 034 034 034 034 034 034 034 034 034 034 034 034 034 034 096 034 034 034 034 034 034 053
055 034 034 034 034 034 034 034 034 034 034 095 094 034 034 034 034 034 034 034 034 034 034 034 034 053
055 034 034 034 034 034 034 034 034 034 034 053 055 034 034 034 034 034 034 034 034 034 034 034 034 053
055 034 034 034 034 034 034 034 034 034 034 053 055 034 034 034 034 034 034 034 034 034 096 034 034 053
055 034 034 034 034 034 034 034 034 034 034 053 055 034 034 034 034 034 034 034 034 034 034 034 034 053
055 034 034 034 034 034 034 034 034 034 034 053 055 034 034 034 034 034 034 034 034 034 034 034 034 053
055 034 034 034 034 034 034 034 034 034 034 053 055 034 034 034 034 034 034 034 034 034 034 096 096 053
055 034 034 034 034 034 034 034 034 034 034 053 055 054 054 054 054 054 054 054 054 054 054 054 054 053
055 034 034 034 034 034 034 034 034 034 034 053 099 099 099 099 099 099 099 099 099 099 099 099 099 099
055 034 034 034 034 034 034 034 034 034 034 053 055 054 054 054 054 054 054 054 054 054 054 054 054 053
055 034 034 034 034 034 034 034 034 034 034 053 055 052 052 052 052 052 052 052 052 052 052 052 052 053
055 034 034 034 034 034 034 034 034 034 034 053 055 104 104 104 104 104 104 104 104 104 104 104 104 053
055 034 034 034 034 034 034 034 034 034 034 053 055 104 104 104 104 104 104 104 104 104 104 104 104 053
055 034 034 034 034 034 034 034 034 034 034 053 055 104 104 104 104 104 104 104 104 104 104 104 104 053
055 034 034 034 034 034 034 034 034 034 034 054 054 104 104 104 104 104 104 104 104 104 104 104 104 053
055 034 034 034 034 034 034 034 034 034 034 052 052 104 104 104 104 104 104 104 104 104 104 104 104 053
055 034 034 034 034 034 034 034 034 034 034 034 034 104 104 104 104 104 104 104 104 104 104 104 104 053
055 034 034 034 034 034 034 034 034 034 034 095 094 104 104 104 104 104 104 104 104 104 104 104 104 053
055 034 034 034 034 034 034 034 034 034 034 053 055 104 104 104 104 104 104 104 104 104 104 104 104 053
055 034 034 034 034 034 034 034 034 034 034 053 055 104 104 104 104 104 104 104 104 104 104 104 104 053
055 034 034 034 034 034 034 034 034 034 034 053 055 104 104 104 104 104 104 104 104 104 104 104 104 053
055 034 034 034 034 034 034 034 034 034 034 053 055 104 104 104 104 104 104 104 104 104 104 104 104 053
055 034 034 034 034 034 034 034 034 034 034 053 055 104 104 104 104 104 104 104 104 104 104 104 104 053
055 054 054 054 054 034 054 054 054 054 054 053 055 054 054 054 054 054 054 054 054 054 054 054 054 053