101 100 100 100 100 100 100 100 100 100 100 100 100 100 100 102
101 100 100 100 100 100 098 098 100 100 100 100 100 100 100 102
101 100 100 100 100 100 098 098 100 100 100 100 100 100 100 102
101 098 098 098 098 098 098 098 098 098 098 098 098 098 098 102
101 098 098 098 098 098 098 098 098 098 098 098 098 098 098 102
101 098 098 098 098 098 098 098 098 098 098 098 098 098 098 102
101 098 098 098 098 098 098 098 098 098 098 098 098 098 098 102
101 098 098 098 098 098 098 098 098 098 098 098 098 098 098 102
101 098 098 098 098 098 098 098 098 098 098 098 098 098 098 102
101 098 098 098 098 098 098 098 098 098 098 098 098 098 098 102
101 098 098 098 098 098 098 098 098 098 098 098 098 098 098 102
101 098 098 098 098 098 098 098 098 098 098 098 098 098 098 102
101 098 098 098 098 098 098 098 098 098 098 098 098 098 098 102
101 098 098 098 098 098 098 098 098 098 098 098 098 098 098 102
101 098 098 098 098 098 098 098 098 098 098 098 098 098 098 102
101 103 103 103 103 103 103 098 103 103 103 103 103 103 103 102
