055 054 054 054 054 054 054 054 054 054 054 054 054 054 054 054 054 054 083 079 054 054 054 054 054 054 054 054 054 054 054 054 054 054 054 054 054 054 054 054 054 054 054 053
055 052 052 052 052 052 052 052 052 052 052 052 052 052 052 052 052 052 083 079 052 052 052 052 052 052 052 052 052 052 052 052 052 052 052 052 052 052 052 052 052 052 052 053
055 052 052 052 052 052 052 052 052 052 052 052 052 052 052 052 052 052 083 079 052 052 088 052 052 052 052 052 052 052 052 052 052 052 052 052 052 052 052 052 052 052 052 053
099 034 034 034 034 034 034 034 034 034 034 034 034 034 034 034 034 034 083 079 034 034 034 034 034 034 034 034 034 034 034 034 034 034 034 034 034 034 034 034 089 089 089 053
055 034 034 034 034 034 034 034 034 034 034 034 034 034 034 034 034 034 083 079 034 034 034 034 034 034 034 034 034 034 034 034 034 034 034 034 034 034 034 034 034 034 034 053
055 034 034 034 034 034 034 034 092 034 034 034 034 034 034 034 034 034 087 086 034 034 034 034 034 034 034 034 034 034 034 034 034 034 034 034 034 034 034 034 034 034 034 053
055 034 034 034 034 034 034 034 034 034 034 034 034 034 034 034 034 034 083 079 034 034 034 034 034 034 034 034 034 034 034 034 034 034 034 089 034 034 034 034 034 034 034 053
055 034 034 034 034 034 034 034 034 034 034 034 034 034 034 034 034 034 083 079 034 034 034 034 034 034 034 034 034 034 034 034 034 034 034 034 034 034 034 034 034 034 034 053
055 034 034 034 034 090 034 034 034 034 034 034 034 034 034 084 077 077 085 085 077 077 078 034 034 034 034 034 034 034 089 034 034 034 034 034 034 034 034 034 034 034 034 053
055 034 034 034 034 034 034 034 034 034 092 034 034 034 034 083 085 085 085 085 085 085 079 034 034 034 034 034 034 034 034 034 034 034 034 034 091 034 034 034 034 034 034 053
055 034 034 034 034 034 034 034 034 034 034 034 034 034 034 083 085 085 085 085 085 085 079 034 034 034 034 090 034 034 034 034 034 034 034 034 034 034 034 034 034 034 034 053
055 034 034 034 034 034 034 089 034 034 034 034 034 034 034 083 085 085 085 085 085 085 079 034 034 034 034 034 034 034 034 034 034 034 034 034 034 034 034 034 090 034 034 053
055 034 034 034 034 034 034 034 034 034 091 034 034 034 034 083 085 081 081 085 085 085 079 034 034 034 034 034 034 034 034 091 034 034 034 034 034 034 034 034 090 034 034 053
055 034 034 034 090 034 034 034 034 034 034 034 034 034 034 083 079 034 034 083 085 085 079 034 034 034 034 034 034 034 034 034 034 034 034 034 089 034 034 034 034 034 034 053
055 034 034 034 034 034 034 034 090 034 034 034 034 034 034 083 079 034 034 083 085 085 079 034 034 034 034 034 034 034 034 034 034 034 034 034 034 034 034 034 034 034 034 053
055 034 034 034 034 034 034 034 034 034 034 034 034 034 034 083 079 034 034 083 085 085 085 077 078 034 034 084 077 077 078 034 034 034 034 034 034 034 034 034 034 034 034 053
055 034 034 034 034 034 034 034 034 034 034 034 034 034 034 083 079 034 034 083 085 085 085 085 079 034 034 083 085 085 079 034 034 034 034 034 034 034 034 034 034 034 034 053
055 092 034 034 034 091 034 034 034 034 034 034 034 034 034 083 085 077 077 085 085 085 085 085 079 034 034 083 085 085 085 078 034 034 034 034 034 034 034 034 034 034 034 053
055 034 034 034 034 034 034 034 091 034 034 034 034 034 034 083 085 085 085 085 085 085 085 085 079 034 034 083 085 085 085 079 034 034 034 034 034 034 034 034 034 034 034 053
055 034 034 034 034 034 034 034 034 034 034 034 034 034 034 083 085 085 085 085 085 085 085 085 079 034 034 082 085 085 085 079 034 034 034 034 034 034 034 034 034 034 034 053
055 034 034 034 034 034 034 034 034 034 034 034 034 034 034 083 085 085 085 085 085 085 085 085 079 034 034 034 083 085 085 079 034 034 034 034 034 034 034 034 034 034 034 053
055 034 034 034 034 034 034 034 034 034 034 034 034 034 034 082 081 081 085 085 081 081 085 085 079 034 034 034 083 085 085 079 034 034 034 034 034 034 034 034 034 034 034 053
055 034 034 034 034 034 034 034 034 034 034 034 034 034 034 034 034 034 083 079 034 034 083 085 085 077 077 077 085 085 085 079 054 054 054 054 054 034 054 054 054 054 054 053
055 034 034 034 034 034 034 034 034 034 034 034 034 034 034 034 034 034 083 079 034 034 083 085 085 085 085 085 085 085 085 079 034 034 034 034 034 034 034 089 089 089 034 053
055 034 034 034 034 034 034 034 034 034 034 034 034 034 034 034 034 034 083 079 034 034 083 085 085 085 085 085 085 085 085 079 034 034 034 034 034 034 034 034 034 034 034 053
055 034 034 034 034 034 034 034 034 034 034 034 034 034 034 034 034 034 083 079 034 034 083 085 085 085 085 085 085 085 085 079 034 034 034 034 034 034 034 034 034 034 034 053
055 034 034 034 034 034 034 034 034 034 034 034 034 034 034 034 034 034 083 079 034 034 082 081 081 081 081 081 081 081 081 080 034 034 034 034 034 034 034 034 034 034 034 053
055 034 034 034 034 034 034 034 034 034 034 034 034 034 034 034 034 034 083 079 034 034 034 034 034 034 034 034 034 034 034 034 034 034 034 034 034 034 034 034 034 034 034 053
055 034 034 034 034 034 034 034 034 034 034 034 034 034 034 034 034 034 082 080 034 034 034 034 034 034 034 034 034 034 034 034 034 034 034 034 034 034 034 034 034 034 034 053
055 034 034 034 034 034 034 089 034 034 034 034 090 034 034 034 034 034 034 034 034 034 034 034 034 034 034 034 034 034 034 034 034 034 034 034 034 034 034 034 034 034 034 053
055 034 034 034 034 034 034 034 034 034 034 034 091 034 034 034 034 034 034 034 034 034 034 034 034 034 034 034 034 034 034 034 034 034 034 034 034 034 034 034 034 034 034 053
055 034 034 034 034 034 034 034 034 034 034 034 034 034 034 034 034 034 034 034 034 034 034 034 034 034 034 034 034 034 034 090 034 091 034 034 034 092 034 034 034 034 034 053
055 034 034 034 034 034 034 034 034 034 034 034 034 034 034 034 034 034 084 078 034 034 034 034 034 034 091 034 034 034 034 034 034 034 034 034 034 034 034 034 034 034 034 053
055 034 034 034 091 091 091 091 034 034 034 034 034 034 034 034 034 034 083 079 034 034 034 034 034 034 091 034 034 034 034 089 034 034 034 034 034 034 034 034 034 034 034 053
055 034 034 034 034 034 034 034 034 034 034 034 034 034 034 034 034 034 083 079 034 034 034 034 034 034 091 034 034 034 034 034 034 034 034 034 034 034 034 034 034 034 034 053
055 034 034 034 034 034 034 034 034 034 034 034 034 034 034 034 034 034 083 079 034 034 034 034 034 034 034 034 034 034 034 034 034 034 034 034 034 034 034 034 034 034 034 053
055 034 034 034 034 034 034 034 034 034 034 034 034 034 034 034 034 034 083 079 034 034 034 034 034 034 034 034 034 034 034 034 034 034 034 034 034 091 091 091 034 034 034 053
055 054 054 054 054 054 054 054 054 054 054 054 054 054 054 054 054 054 083 079 054 054 054 054 054 054 054 054 054 054 054 054 054 054 054 054 054 054 054 054 054 054 054 053