001 001 001 001 001 001 001 001 001 001 001 001 001 001 001 001 001 001 001 001 001 001 001 001 001 001 001 001 001 001 001 001 001 001 001 001 001 001 001 001 027 028 023 001 001
001 001 001 001 001 001 001 001 000 000 000 000 000 000 000 000 000 000 000 000 000 001 001 001 001 001 000 001 000 000 000 001 000 000 000 000 000 000 000 000 027 028 023 000 001
001 001 001 001 001 001 000 000 000 000 000 000 000 000 000 000 000 000 000 001 000 001 001 001 001 001 000 000 001 000 001 000 000 000 001 000 000 000 000 000 027 028 023 000 001
001 001 000 001 000 000 000 000 000 000 000 000 000 000 000 000 000 000 000 000 000 001 001 001 001 001 000 000 000 000 001 001 000 001 001 001 000 000 000 000 027 028 023 000 001
001 001 000 000 000 000 000 000 000 000 000 000 000 000 000 035 022 022 022 035 000 000 001 001 001 001 000 000 000 000 000 000 000 000 001 000 000 000 000 000 027 028 023 000 001
001 000 000 000 000 000 000 000 000 000 035 000 000 000 035 027 028 028 028 023 000 000 001 001 001 000 001 001 000 001 001 000 000 000 000 000 000 022 022 022 039 028 023 000 001
001 000 000 000 000 000 000 000 000 000 000 000 000 000 000 027 028 028 028 023 000 000 000 001 001 000 001 000 001 000 000 000 000 000 000 000 027 028 028 028 028 028 023 000 001
001 000 000 000 000 000 000 000 000 000 000 000 000 000 000 027 028 028 028 023 000 000 000 001 001 001 000 000 000 000 001 001 001 000 000 001 027 028 037 025 025 025 000 000 001
001 000 000 000 000 000 035 000 000 000 036 000 000 000 000 027 028 028 028 040 022 022 000 001 000 000 001 000 000 000 000 001 000 000 000 001 027 028 023 000 000 000 000 000 001
001 000 000 000 000 000 000 000 000 000 000 000 035 000 000 027 028 028 028 028 028 028 023 000 000 001 000 000 001 000 000 001 000 001 000 000 027 028 023 001 001 000 000 000 001
001 000 000 001 000 000 000 000 000 000 000 000 000 000 000 000 025 025 025 025 038 028 040 022 000 000 001 000 001 000 000 000 000 000 000 000 027 028 023 000 000 000 000 000 001
001 000 000 000 000 035 000 000 000 035 000 000 000 000 000 000 000 000 036 000 027 028 028 028 023 000 000 000 001 000 000 000 000 000 000 000 027 028 023 000 000 000 000 000 001
001 000 000 000 000 000 000 000 000 000 000 000 000 000 000 000 000 000 000 000 000 025 038 028 023 000 000 000 001 000 000 000 000 000 000 000 027 028 023 000 000 000 000 000 001
001 000 000 000 036 000 000 000 000 000 000 000 000 000 036 000 000 000 000 035 000 000 027 028 023 000 000 000 001 000 000 022 022 022 022 022 039 028 023 000 000 000 001 000 001
001 000 000 000 000 000 000 001 000 000 000 000 000 000 000 000 000 000 000 000 000 000 027 028 023 000 000 000 001 000 027 028 028 028 028 028 028 028 023 000 000 000 000 000 001
001 000 000 000 000 000 000 000 000 036 000 000 000 000 000 000 000 000 000 000 000 000 027 028 040 022 022 022 022 022 039 028 037 025 025 025 025 025 000 000 000 000 000 000 001
001 000 000 035 000 000 000 000 000 000 000 000 000 000 000 035 000 000 036 000 000 000 027 028 028 028 028 028 028 028 028 028 023 000 000 000 000 000 000 000 001 000 000 000 001
001 000 000 000 000 000 000 036 000 000 000 000 000 000 000 000 000 000 035 000 000 000 000 025 025 025 025 025 025 025 025 025 000 000 000 000 000 000 001 000 000 000 000 000 001
001 000 000 000 001 000 000 001 000 001 000 001 000 000 000 036 000 000 000 000 000 000 000 000 000 000 000 000 000 000 000 000 000 000 000 000 000 000 000 000 000 000 000 001 001
001 000 000 000 000 000 000 000 000 000 000 000 000 000 000 000 000 000 000 000 000 000 000 000 000 000 000 000 000 001 000 001 000 001 000 001 000 000 000 000 000 000 000 001 001
001 000 000 000 000 001 000 000 000 000 000 000 000 000 000 000 000 000 000 000 000 000 000 000 000 000 000 000 001 000 000 000 000 000 000 001 001 000 000 001 000 000 000 001 001
001 001 000 000 000 000 000 000 000 000 000 000 000 000 000 000 000 000 000 000 000 001 000 000 000 000 001 000 001 001 001 000 001 000 000 000 000 000 001 001 001 001 001 001 001
001 001 000 000 000 001 000 000 001 000 000 001 000 000 000 000 000 000 000 000 000 001 000 001 000 000 001 000 001 001 001 000 001 000 001 001 000 000 001 001 001 001 001 001 001
001 001 000 000 000 000 000 000 000 000 000 000 001 001 001 001 001 001 000 000 000 001 001 001 001 000 001 001 001 001 001 001 001 000 001 001 000 001 001 001 001 001 001 001 001
001 001 001 001 001 001 001 001 001 001 001 001 001 001 001 001 001 001 001 001 001 001 001 001 001 001 001 001 001 001 001 001 001 001 001 001 001 001 001 001 001 001 001 001 001