055 054 054 054 054 054 054 054 054 054 054 054 054 053
055 052 052 052 052 052 052 052 052 052 052 052 052 053
055 052 052 052 052 052 052 052 052 052 052 052 052 053
055 048 048 048 048 049 049 049 049 048 048 048 048 053
055 048 048 048 048 048 048 048 048 048 048 048 048 053
055 048 048 048 048 048 048 048 048 048 048 048 048 053
055 048 048 048 048 048 048 048 048 048 048 048 048 053
055 048 048 048 048 048 060 061 048 048 048 048 048 053
055 048 048 050 051 048 060 061 048 050 051 048 048 053
055 048 048 048 048 048 060 061 048 048 048 048 048 053
055 048 048 050 051 048 060 061 048 050 051 048 048 053
055 048 048 048 048 048 060 061 048 048 048 048 048 053
055 048 048 050 051 048 060 061 048 050 051 048 048 053
055 048 048 048 048 048 060 061 048 048 048 048 048 053
055 048 048 050 051 048 060 061 048 050 051 048 048 053
055 048 048 048 048 048 060 061 048 048 048 048 048 053
055 048 048 048 048 048 060 061 048 048 048 048 048 053
055 048 048 048 048 048 060 061 048 048 048 048 048 053
055 048 048 048 048 048 048 048 048 048 048 048 048 053
055 054 054 054 054 054 054 048 054 054 054 054 054 053