055 054 054 054 054 054 054 054 054 054 054 054 054 054 054 054 054 054 054 054 054 054 054 054 054 054 054 054 054 054 054 054 054 054 054 054 054 054 054 054 054 054 054 054 054 054 054 053
055 052 052 052 052 052 052 052 052 052 052 052 052 052 052 052 052 052 052 052 052 052 052 052 052 052 052 052 052 052 052 052 052 052 052 052 052 052 052 052 052 052 052 052 052 052 052 053
055 052 052 052 052 052 052 052 052 052 052 052 052 052 052 052 052 052 052 052 052 052 052 052 052 052 052 052 052 052 052 052 052 052 052 052 052 052 052 052 052 052 052 052 052 052 052 053
055 068 068 068 068 068 068 068 068 068 068 068 068 068 068 068 068 068 068 068 068 068 068 068 068 068 068 068 068 068 068 068 068 068 068 068 068 068 068 068 068 068 068 068 068 068 068 053
055 068 068 071 072 068 068 068 068 068 068 074 068 068 075 068 068 068 068 068 071 072 068 068 075 068 068 068 068 068 069 068 068 075 068 068 068 068 068 068 068 068 075 068 068 068 068 053
055 068 068 068 068 068 068 068 068 068 068 068 068 068 068 068 069 068 068 068 068 068 068 068 068 068 068 068 068 068 070 068 068 068 068 068 068 068 068 068 068 068 068 068 068 068 068 053
055 068 068 068 068 068 068 068 074 068 068 068 068 069 068 068 070 068 068 068 068 068 068 068 068 068 068 074 068 068 070 068 068 068 068 068 068 075 068 068 068 068 068 068 068 068 068 053
099 068 068 068 068 068 068 068 068 068 068 068 068 070 068 068 070 068 068 068 068 068 068 068 068 068 068 068 068 068 070 068 068 068 068 068 068 068 068 068 068 068 068 068 068 068 068 053
055 068 068 068 068 068 068 068 068 068 068 068 068 054 068 068 054 068 068 068 075 068 068 071 072 068 068 068 068 068 054 068 068 068 068 068 068 068 068 068 068 068 068 068 068 068 068 053
055 068 068 068 068 068 068 068 068 068 068 068 068 068 068 068 068 068 068 068 068 068 068 068 068 068 068 068 068 068 068 068 068 068 068 068 068 068 068 068 068 068 068 074 068 068 068 053
055 068 068 068 068 068 068 068 068 068 068 068 068 068 068 068 068 071 072 068 068 068 068 068 068 068 069 068 068 068 068 068 071 072 068 068 068 068 068 068 068 068 068 068 068 068 068 053
055 068 068 068 068 068 068 075 068 068 068 068 068 075 068 068 068 068 068 068 068 068 068 074 068 068 070 068 068 068 068 068 068 068 068 068 068 068 075 068 068 068 068 068 068 068 068 053
055 068 068 068 068 068 068 068 068 068 068 068 068 068 068 068 068 068 068 068 068 068 068 068 068 068 070 068 068 068 068 068 068 068 068 068 068 068 068 068 068 068 068 068 068 068 068 053
055 054 054 054 054 054 054 054 054 054 054 054 054 054 054 054 054 054 054 054 054 054 054 054 054 054 054 054 054 054 054 054 054 054 054 054 054 054 054 054 054 054 054 054 054 054 054 053